1
7
10
5
5
4
9
18
##########
#        #
#  ##### #
## #   # #
#  #  #  
#      # #
##########